
HSF = "countries/heisenfeng.txt"
RYU = "countries/Ryukyu.txt"
MMR = "countries/Myanmar.txt"
NPT = "countries/EastEur.txt"
ARF = "countries/EastEur.txt"
BLA = "countries/EastEur.txt"
PPT = "countries/EastEur.txt"  #紫耀之都
LAS = "countries/EastEur.txt"  #黑土边域
LOW = "countries/EastEur.txt"  #白露之滨
LEA = "countries/EastEur.txt"  #绿荫箱庭
LDD = "countries/Rhodes.txt"
ARA = "countries/Aragon.txt"


MGU = "countries/Magicunion.txt"
MGS = "countries/Magius.txt"
DVL = "countries/Deviluke.txt"
HKR = "countries/Hakurei.txt"
MRY = "countries/Moriya.txt"
KMK = "countries/Koumakan.txt"
TRB = "countries/Train.txt"
SWB = "countries/Switzerlandbank.txt"
ROC = "countries/Republic of China.txt"
ROV = "countries/Republic of VIN.txt"
DV1 = "countries/Deviluke_1.txt"
DV2 = "countries/Deviluke_2.txt"
KMS = "countries/Kriegsmarine.txt"
######戴比总督区
DVF = "countries/Devilukefrance.txt"
DVN = "countries/DVN.txt"
DVP = "countries/DVP.txt"
DVE = "countries/DVE.txt"
DVI = "countries/DVI.txt"
DVR = "countries/DVR.txt"
DVB = "countries/DVB.txt"
DVD = "countries/DVD.txt"
DVM = "countries/DVM.txt"
#####
GEU = "countries/Germany_union.txt"
#西伯利亚共和国 siberia
SIB = "countries/SIB.txt"
#远东共和国 east amur
EAM = "countries/EAM.txt"
#小马共和国 tamerlane
TAM = "countries/TAM.txt"
#波罗的海 Baltic Sea
BAL = "countries/BAL.txt"